{
  "tiles": [
    0, 0, 0, 0, 28, 28, 29, 29, 28, 28, 28, 0, 0, 0, 0, 0, 0, 0, 25, 25, 25, 25,
    0, 0, 0, 0, 0, 0, 0, 0, 0, 0, 0, 0, 28, 28, 29, 29, 28, 23, 28, 25, 25, 25,
    25, 25, 25, 25, 25, 17, 17, 25, 0, 0, 0, 0, 0, 0, 0, 0, 0, 0, 0, 0, 28, 28,
    29, 29, 28, 24, 28, 25, 12, 12, 12, 12, 12, 12, 12, 12, 12, 25, 25, 25, 0,
    0, 0, 0, 0, 0, 0, 0, 0, 0, 28, 28, 29, 29, 28, 28, 28, 25, 12, 12, 19, 19,
    19, 19, 19, 12, 12, 12, 22, 25, 0, 0, 0, 0, 0, 0, 0, 0, 0, 0, 28, 28, 29,
    29, 29, 29, 29, 27, 12, 12, 12, 12, 12, 12, 12, 12, 12, 12, 22, 25, 0, 0, 0,
    0, 0, 0, 0, 0, 0, 0, 28, 28, 28, 28, 28, 28, 28, 25, 12, 12, 12, 12, 12, 12,
    12, 12, 12, 12, 22, 25, 0, 0, 0, 0, 0, 0, 0, 0, 0, 0, 25, 25, 25, 25, 25,
    25, 25, 25, 25, 25, 12, 12, 20, 12, 12, 20, 12, 12, 25, 25, 25, 25, 25, 25,
    25, 25, 0, 0, 0, 0, 25, 21, 21, 21, 25, 25, 25, 18, 18, 25, 26, 25, 25, 25,
    25, 25, 25, 25, 25, 18, 18, 25, 12, 13, 12, 25, 0, 0, 0, 0, 25, 12, 12, 12,
    12, 12, 12, 12, 12, 12, 12, 12, 26, 12, 12, 12, 22, 25, 12, 12, 12, 25, 12,
    12, 12, 25, 0, 0, 0, 0, 25, 12, 12, 12, 12, 12, 12, 12, 12, 12, 12, 12, 25,
    12, 12, 12, 22, 25, 22, 12, 12, 25, 12, 12, 22, 25, 0, 25, 25, 25, 25, 25,
    25, 25, 12, 12, 19, 19, 19, 19, 12, 12, 25, 12, 13, 12, 12, 25, 22, 12, 12,
    25, 12, 12, 22, 25, 0, 25, 12, 12, 12, 25, 17, 12, 12, 12, 12, 12, 12, 12,
    12, 12, 25, 25, 25, 25, 25, 25, 22, 12, 12, 25, 26, 25, 25, 25, 0, 25, 19,
    12, 19, 25, 17, 12, 12, 12, 12, 12, 12, 12, 12, 12, 26, 12, 12, 12, 12, 12,
    12, 12, 12, 12, 12, 25, 25, 0, 0, 25, 12, 12, 12, 25, 25, 25, 12, 12, 20,
    12, 12, 20, 12, 12, 25, 12, 20, 12, 20, 12, 20, 12, 12, 12, 12, 17, 25, 0,
    0, 25, 19, 12, 12, 12, 12, 26, 12, 12, 20, 12, 12, 12, 12, 12, 25, 12, 20,
    12, 20, 12, 20, 12, 12, 12, 12, 17, 25, 0, 0, 25, 12, 12, 12, 12, 12, 25,
    12, 12, 12, 12, 12, 12, 12, 12, 25, 12, 12, 12, 12, 12, 12, 12, 12, 12, 12,
    25, 25, 0, 25, 25, 25, 25, 25, 25, 25, 25, 25, 25, 25, 27, 27, 25, 25, 25,
    25, 25, 25, 25, 25, 25, 25, 25, 27, 27, 25, 25, 25, 25, 0, 0, 0, 0, 0, 0, 0,
    28, 28, 28, 28, 29, 29, 28, 28, 28, 28, 23, 28, 28, 28, 28, 28, 28, 29, 29,
    28, 28, 28, 28, 0, 0, 0, 0, 0, 0, 0, 28, 28, 28, 28, 29, 29, 28, 28, 24, 28,
    23, 28, 28, 24, 28, 28, 28, 29, 29, 28, 28, 28, 28, 0, 0, 0, 0, 0, 0, 0, 28,
    28, 28, 28, 29, 29, 28, 28, 23, 28, 23, 28, 28, 23, 28, 28, 28, 29, 29, 28,
    28, 28, 28, 0, 0, 0, 0, 0, 0, 0, 28, 28, 28, 28, 29, 29, 28, 28, 28, 28, 23,
    28, 28, 28, 28, 28, 28, 29, 29, 28, 28, 28, 28, 0, 0, 0, 0, 0, 0, 0, 29, 29,
    29, 29, 29, 29, 29, 29, 29, 28, 23, 28, 29, 29, 29, 29, 29, 29, 29, 29, 29,
    29, 29, 0, 0, 0, 0, 0, 0, 0, 28, 28, 28, 28, 28, 28, 28, 28, 29, 28, 23, 28,
    29, 28, 28, 28, 28, 28, 28, 28, 28, 28, 28, 0, 0, 0, 0, 0, 0, 0, 28, 28, 28,
    28, 28, 28, 28, 28, 29, 28, 23, 28, 29, 28, 28, 28, 28, 28, 28, 28, 28, 28,
    28, 0, 0, 0, 0, 0, 0, 0, 0, 0, 0, 0, 0, 0, 0, 0, 0, 0, 0, 0, 0, 0, 0, 0, 0,
    0, 0, 0, 0, 0, 0, 0, 0, 0, 0, 0, 0, 0, 0, 0, 0, 0, 0, 0, 0, 0, 0, 0, 0, 0,
    0, 0, 0, 0, 0, 0, 0, 0, 0, 0, 0, 0, 0, 0, 0, 0, 0, 0, 0, 0, 0, 0, 0, 0, 0,
    0, 0, 0, 0, 0, 0, 0, 0, 0, 0, 0, 0, 0, 0, 0, 0, 0, 0, 0, 0, 0, 0, 0, 0, 0,
    0, 0, 0, 0, 0, 0, 0, 0, 0, 0, 0, 0, 0, 0, 0, 0, 0, 0, 0, 0, 0, 0, 0, 0, 0,
    0, 0, 0, 0, 0, 0, 0, 0, 0, 0, 0, 0, 0, 0, 0, 0, 0, 0, 0, 0, 0, 0, 0, 0, 0,
    0, 0, 0, 0, 0, 0, 0, 0, 0, 0, 0, 0, 0, 0, 0, 0, 0, 0, 0, 0, 0, 0, 0, 0, 0,
    0, 0, 0, 0, 0, 0
  ],
  "spawns": [
    [14, 23],
    [6, 21],
    [19, 23],
    [28, 21],
    [5, 0],
    [6, 0]
  ],
  "width": 30,
  "height": 30
}
